
NO ./textures/north

               SO            ./textures/south

        EA           ./textures/east

WE           ./textures/west

                       F 0,255,0

    C     255,0,255

11111111111111111
10000000000000001
10000000000000001  1111
10000000000000001  1001
10000011111111111  1111
1000001
1000001     11111111111111111111111
1000001     10000000000000000000001
1000001     11111100000111111111101
1000001          1000001        101
100000111111111111000001  1111  101
111100000000000000000001  1001  101
   100000000000000000001  1111  101
   100111111111111000001        101
1111001          100000111111111101
1000001          100000000000000001
1000001          100000000000000001
1000001   1111111100000111111111111
1000001   10000000000001
1000001   10000000000001
1000001   10011111000001
1000001   1001   1000001
1000001   1001   1001001
1000001   1001   1000001
1000001111100111110000011111111111111111
1000000000000000000000000000000000000001
1000111111001111100000111000000000000001
10001    1000000001000001000000111100001
10001111110000111110110000000001  100001
100000000000000000000000N0000001  100001
11111111111111111111111111111111  111111
