11111111111111111
100000P001000P001
01111111      111
0010000001
1010010010000001
10011010010000001
1011001
100001
1000000001
1111111111


	111111111111111111111111111111111111111111111
i->	111111111111                              11
	10000P0 000111111
	11111111000111111
	       1000000001
	       1111111111


010
1P1
010

map[0][j = 0]
map[0][j = found(end)]